wwwwwwwwwwwww
w..3.ww....Aw
w....w......w
w.b....bwwwww
w.b..t.....1w
w.b...wwwwwww
w.......w...w
w...2w....w.w
wwwwwwwwwwwwT