wwwwwwwwwwwwwwwwwwwwwwwwwww
wgggggggggggggggggggggggggw
wdddddddddddddddddddddddddw
w....3....................w
w.....3...........2.....f.w
w........2................w
w.........................w
wwwwwwwwwwwwwwww..wwwwwwwww
w......k..................w
w.........................w
w......................c..w
w.........................w
w.........................w
wA........................w
wwwwwwwwwwwwwwwwwwwwwwwwwww